******************
*P*           *  X
* * * ********* **
* * *@  * *     *
* * * * * *** * *
* * * * %   * * *
* *** ***** * ***
*     *   *   * *
* ***** * * *** *
* *  @  * *   % *
* * * *** *** * *
* * * *   *   * *
* * * * *** *** *
* * * % *     * *
* *** * ***** * *
*     *         *
*****************